Kyle Kissler
[
[ 0, 0, 0, 0, 0, 0, 0, 0, 0, 0, 0, 0, 0, 0, 0, 0, 0, 0, 0, 0, 0, 0, 0, 0, 0, 0, 0, 0, 0, 0, 0,],
[ 0, 0, 0, 0, 0, 0, 0, 0, 0, 0, 0,19,19,19,19,19,19,19, 0, 0, 0, 0, 0, 0, 0, 0, 0, 0, 0, 0, 0,],
[ 0, 0, 0, 0, 0, 0, 0, 0, 0, 0,19,19,19,19,19,19,19,19, 0, 0, 0, 0, 0, 0, 0, 0, 0, 0, 0, 0, 0,],
[ 0, 0, 0, 0, 0, 0, 0, 0, 0, 0,19,19,19,19,19,19,19,19,19,19,19, 0, 0, 0, 0, 0, 0, 0, 0, 0, 0,],
[ 0, 0, 0, 0, 0, 0, 0, 0, 0, 0,19,19,19,19,19,19,19,19,19,19,19, 0, 0, 0, 0, 0, 0, 0, 0, 0, 0,],
[ 0, 0, 0, 0, 0, 0, 0, 0, 0, 0,19,19,19,19,19,19,19,19,19,19,19,19, 0, 0, 0, 0, 0, 0, 0, 0, 0,],
[ 0, 0, 0, 0, 0, 0, 0, 0, 0, 0,19,19,19,18,18,18,19,19,19,19,19,19, 0, 0, 0, 0, 0, 0, 0, 0, 0,],
[ 0, 0, 0, 0, 0, 0, 0, 0, 0, 0,19,19,19,18,18,18, 1, 0,18,18,19,19, 0, 0, 0, 0, 0, 0, 0, 0, 0,],
[ 0, 0, 0, 0, 0, 0, 0, 0, 0, 0, 0, 0, 0,18,18,18, 1, 1,18,18, 0, 0, 0, 0, 0, 0, 0, 0, 0, 0, 0,],
[ 0, 0, 0, 0, 0, 0, 0, 0, 0, 0, 1, 1, 1,18,18,18, 1, 1,18, 0, 0, 0, 0, 0, 0, 0, 0, 0, 0, 0, 0,],
[ 0, 0, 0, 0, 0, 0, 0, 0, 0, 0, 1, 1, 1,18,18,18, 1, 1, 0, 0, 0, 0, 0, 0, 0, 0, 0, 0, 0, 0, 0,],
[16, 0, 0, 0, 0, 0, 0, 0, 0, 0, 1, 1, 1,18,18,18, 1, 1, 1, 0, 0, 0, 0, 0, 0, 0, 0, 0, 0, 0, 0,],
[ 0, 0, 0, 0, 0, 0, 0, 0, 0, 0, 1, 1, 1,18,18,18, 1, 1, 1, 0, 0, 0, 0, 0, 0, 0, 0, 0, 0, 0, 0,],
[ 0, 0, 0, 0, 0, 0, 0, 0, 0, 0, 1, 1, 1,18,18,18, 1, 1, 1, 1, 0, 0, 0, 0, 5, 0, 0, 0, 0, 0, 0,],
[ 0, 0, 0, 0, 0, 0, 0, 0, 0, 0, 1, 1, 1,18,18,18, 1, 1, 1, 1, 1, 1, 1, 1, 1, 1, 1, 1, 1, 1, 1,],
[ 0, 0, 0, 0, 0, 0, 0, 0, 0, 0, 0, 0,18,18,18,18,18,18,18,18,18,18,18,18,18,18,18,18, 1, 1, 1,],
[ 0, 0, 0, 4, 0, 0, 0, 0, 0, 0, 0,18,18,18,18,18,18,18,18,18,18,18,18,18,18,18,18,18,18, 1, 1,],
[ 1, 1, 1, 1,23,23,23,23, 1, 1, 1, 1, 1,23,23,23, 1, 1, 1, 1, 1, 2, 2, 2,18,18,18,18,18, 1, 1,],
[ 1, 1, 1, 1,18,18,18,18, 1, 1, 1, 1, 1,18,18,18,18,18,18,18,18,18,18,18,18,18,18,18,18, 1, 1,],
[ 1, 1, 1, 1,18,18,18,18,18,18,18,18,18,18,18,18,18,18,18,18,18,18,18,18,18,18,18,18, 1, 1, 1,],
[ 1, 1, 1, 1,18,18,18,18,18,18,18,18,18,18, 7,18,18, 3,18,18,18,18,18,18,18,18,18, 1, 1, 1, 1,],
[ 1, 1, 1, 1,18,18,18,18,18,18,18,18,18,18,18,18, 3, 1, 1, 1, 1, 1, 1, 1, 1, 1, 1, 1, 1, 1, 1,],
[ 1, 1, 1, 1, 1, 1, 1, 1, 1, 1, 1, 1, 1, 1, 1, 1, 1, 1, 1, 1, 1, 1, 1, 1, 1, 1, 1, 1, 1, 1, 1,],
[ 1, 1, 1, 1, 1, 1, 1, 1, 1, 1, 1, 1, 1, 1, 1, 1, 1, 1, 1, 1, 1, 1, 1, 1, 1, 1, 1, 1, 1, 1, 1,],
[ 1, 1, 1, 1, 1, 1, 1, 1, 1, 1, 1, 1, 1, 1, 1, 1, 1, 1, 1, 1, 1, 1, 1, 1, 1, 1, 1, 1, 1, 1, 1,],
]